2 3
G L H
I M J
+---+---+---+
|           |
+   +   +   +
|           |
+---+---+---+