6 6
. . . . . .
# . . # . .
. . # # . .
. . . # . #
. . E # S .
. . . . . .